10
7 7
2 3
XXXXXXX
X_____X
X_____X
X_____X
X_____X
X____EX
XXXXXXX
7 7
2 3
XXXXXXX
X_____X
X____XX
X____XX
X____XX
X____EX
XXXXXXX
8 8
2 2
XXXXXXXX
X______X
X_XXXXXX
X_X____X
X_XXXXXX
X_X____X
X_X___EX
XXXXXXXX
5 10
2 2
XXXXXXXXXX
X________X
X___XX___X
X_XX_XXXEX
XXXXXXXXXX
5 10
2 2
XXXXXXXXXX
X_X_X_XXXX
XX___X_X_X
X_X_XXX_EX
XXXXXXXXXX
10 10
6 4
XXXXXXXXXX
XEX______X
X_X_X_X_XX
X_X_X_X__X
X_X_X_X_XX
X_X_X_X_XX
X___X_X_XX
X_____X__X
X___XX___X
XXXXXXXXXX
10 10
4 2
XXXXXXXXXX
X_X_X_X_EX
X_X_X_X_XX
X_X_X_X_XX
X_X_X_X_XX
X_X_X_X_XX
X_X_X_X_XX
X_X_X_X_XX
X_______XX
XXXXXXXXXX
10 10
2 9
XXXXXXXXXX
X____X___X
X_X__X___X
X_X__X___X
X_XX_X___X
X_X__X___X
X_X__X___X
X_X_XX___X
XEX______X
XXXXXXXXXX
12 12
4 4
XXXXXXXXXXXX
X____X___X_X
X_X__X___XEX
X_X__X___X_X
X_XX_X___X_X
X_X__X_____X
X_X__X___XXX
X_X_XXXX_XXX
X_X_______XX
X_X_XXXX___X
X_X______XXX
XXXXXXXXXXXX
100 100
42 46
XXXXXXXXXXXXXXXXXXXXXXXXXXXXXXXXXXXXXXXXXXXXXXXXXXXXXXXXXXXXXXXXXXXXXXXXXXXXXXXXXXXXXXXXXXXXXXXXXXXX
X__________________________________________________________________________________________________X
X__________________________________________________________________________________________________X
X__________________________________________________________________________________________________X
X__________________________________________________________________________________________________X
X__________________________________________________________________________________________________X
X__________________________________________________________________________________________________X
X__________________________________________________________________________________________________X
X__________________________________________________________________________________________________X
X__________________________________________________________________________________________________X
X__________________________________________________________________________________________________X
X__________________________________________________________________________________________________X
X__________________________________________________________________________________________________X
X__________________________________________________________________________________________________X
X__________________________________________________________________________________________________X
X__________________________________________________________________________________________________X
X__________________________________________________________________________________________________X
X__________________________________________________________________________________________________X
X__________________________________________________________________________________________________X
X__________________________________________________________________________________________________X
X__________________________________________________________________________________________________X
X__________________________________________________________________________________________________X
X__________________________________________________________________________________________________X
X__________________________________________________________________________________________________X
X__________________________________________________________________________________________________X
X__________________________________________________________________________________________________X
X__________________________________________________________________________________________________X
X__________________________________________________________________________________________________X
X__________________________________________________________________________________________________X
X__________________________________________________________________________________________________X
X__________________________________________________________________________________________________X
X__________________________________________________________________________________________________X
X__________________________________________________________________________________________________X
X__________________________________________________________________________________________________X
X__________________________________________________________________________________________________X
X__________________________________________________________________________________________________X
X__________________________________________________________________________________________________X
X__________________________________________________________________________________________________X
X__________________________________________________________________________________________________X
X__________________________________________________________________________________________________X
X__________________________________________________________________________________________________X
X__________________________________________________________________________________________________X
X__________________________________________________________________________________________________X
X__________________________________________________________________________________________________X
X__________________________________________________________________________________________________X
X__________________________________________________________________________________________________X
X__________________________________________________________________________________________________X
X__________________________________________________________________________________________________X
X__________________________________________________________________________________________________X
X__________________________________________________________________________________________________X
X__________________________________________________________________________________________________X
X__________________________________________________________________________________________________X
X__________________________________________________________________________________________________X
X__________________________________________________________________________________________________X
X__________________________________________________________________________________________________X
X__________________________________________________________________________________________________X
X__________________________________________________________________________________________________X
X__________________________________________________________________________________________________X
X__________________________________________________________________________________________________X
X__________________________________________________________________________________________________X
X__________________________________________________________________________________________________X
X__________________________________________________________________________________________________X
X__________________________________________________________________________________________________X
X__________________________________________________________________________________________________X
X__________________________________________________________________________________________________X
X__________________________________________________________________________________________________X
X__________________________________________________________________________________________________X
X__________________________________________________________________________________________________X
X__________________________________________________________________________________________________X
X__________________________________________________________________________________________________X
X__________________________________________________________________________________________________X
X__________________________________________________________________________________________________X
X__________________________________________________________________________________________________X
X__________________________________________________________________________________________________X
X__________________________________________________________________________________________________X
X__________________________________________________________________________________________________X
X__________________________________________________________________________________________________X
X__________________________________________________________________________________________________X
X__________________________________________________________________________________________________X
X__________________________________________________________________________________________________X
X__________________________________________________________________________________________________X
X____________________________________________________XXXXXXXXXXX___________________________________X
X____________________________________________________XX____________________________________________X
X____________________________________________________XX____________________________________________X
X____________________________________________________XX____________________________________________X
X____________________________________________________XX____________________________________________X
X____________________________________________________XX____________________________________________X
X____________________________________________________XX____________________________________________X
X__________________________________________________________________________________________________X
X________________________________________________________________E_________________________________X
X__________________________________________________________________________________________________X
X__________________________________________________________________________________________________X
X__________________________________________________________________________________________________X
X__________________________________________________________________________________________________X
X__________________________________________________________________________________________________X
X__________________________________________________________________________________________________X
X__________________________________________________________________________________________________X
X__________________________________________________________________________________________________X
X__________________________________________________________________________________________________X
XXXXXXXXXXXXXXXXXXXXXXXXXXXXXXXXXXXXXXXXXXXXXXXXXXXXXXXXXXXXXXXXXXXXXXXXXXXXXXXXXXXXXXXXXXXXXXXXXXXX